UNIPROTKB	ACC+ID	ACC+ID
UNIPROTKB_ID	ID	ID
GENENAME	GENENAME	GENENAME
UNIPARC	UPARC	UPARC
UNIREF50	NF50	NF50
UNIREF90	NF90	NF90
UNIREF100	NF100	NF100
EMBL/GENBANK/DDBJ	EMBL_ID	EMBL_ID
EMBL/GENBANK/DDBJ_CDS	EMBL	EMBL
PIR	PIR	PIR
ENTREZ_GENE	P_ENTREZGENEID	P_ENTREZGENEID
GI_NUMBER*	P_GI	P_GI
REFSEQ_PROTEIN	P_REFSEQ_AC	P_REFSEQ_AC
REFSEQ_NUCLEOTIDE	REFSEQ_NT_ID	REFSEQ_NT_ID
PDB	PDB_ID	PDB_ID
DISPROT	DISPROT_ID	DISPROT_ID
HSSP	HSSP_ID	HSSP_ID
DIP	DIP_ID	DIP_ID
MINT	MINT_ID	MINT_ID
ALLERGOME	ALLERGOME_ID	ALLERGOME_ID
MEROPS	MEROPS_ID	MEROPS_ID
PEROXIBASE	PEROXIBASE_ID	PEROXIBASE_ID
PPTASEDB	PPTASEDB_ID	PPTASEDB_ID
REBASE	REBASE_ID	REBASE_ID
TCDB	TCDB_ID	TCDB_ID
PHOSSITE	PHOSSITE_ID	PHOSSITE_ID
DMDM	DMDM_ID	DMDM_ID
AARHUS/GHENT-2DPAGE	AARHUS_GHENT_2DPAGE_ID	AARHUS_GHENT_2DPAGE_ID
ECO2DBASE	ECO2DBASE_ID	ECO2DBASE_ID
WORLD-2DPAGE	WORLD_2DPAGE_ID	WORLD_2DPAGE_ID
DNASU	DNASU_ID	DNASU_ID
ENSEMBL	ENSEMBL_ID	ENSEMBL_ID
ENSEMBL_PROTEIN	ENSEMBL_PRO_ID	ENSEMBL_PRO_ID
ENSEMBL_TRANSCRIPT	ENSEMBL_TRS_ID	ENSEMBL_TRS_ID
ENSEMBL_GENOMES	ENSEMBLGENOME_ID	ENSEMBLGENOME_ID
ENSEMBL_GENOMES PROTEIN	ENSEMBLGENOME_PRO_ID	ENSEMBLGENOME_PRO_ID
ENSEMBL_GENOMES TRANSCRIPT	ENSEMBLGENOME_TRS_ID	ENSEMBLGENOME_TRS_ID
GENEID	P_ENTREZGENEID	P_ENTREZGENEID
GENOMEREVIEWS	GENOMEREVIEWS_ID	GENOMEREVIEWS_ID
KEGG	KEGG_ID	KEGG_ID
PATRIC	PATRIC_ID	PATRIC_ID
TIGR	TIGR_ID	TIGR_ID
UCSC	UCSC_ID	UCSC_ID
VECTORBASE	VECTORBASE_ID	VECTORBASE_ID
AGD	AGD_ID	AGD_ID
ARACHNOSERVER	ARACHNOSERVER_ID	ARACHNOSERVER_ID
CGD	CGD	CGD
CONOSERVER	CONOSERVER_ID	CONOSERVER_ID
CYGD	CYGD_ID	CYGD_ID
DICTYBASE	DICTYBASE_ID	DICTYBASE_ID
ECHOBASE	ECHOBASE_ID	ECHOBASE_ID
ECOGENE	ECOGENE_ID	ECOGENE_ID
EUHCVDB	EUHCVDB_ID	EUHCVDB_ID
EUPATHDB	EUPATHDB_ID	EUPATHDB_ID
FLYBASE	FLYBASE_ID	FLYBASE_ID
GENECARDS	GENECARDS_ID	GENECARDS_ID
GENEFARM	GENEFARM_ID	GENEFARM_ID
GENOLIST	GENOLIST_ID	GENOLIST_ID
H-INVDB	H_INVDB_ID	H_INVDB_ID
HGNC	HGNC_ID	HGNC_ID
HPA	HPA_ID	HPA_ID
LEGIOLIST	LEGIOLIST_ID	LEGIOLIST_ID
LEPROMA	LEPROMA_ID	LEPROMA_ID
MAIZEGDB	MAIZEGDB_ID	MAIZEGDB_ID
MIM	MIM_ID	MIM_ID
MGI	MGI_ID	MGI_ID
NEXTPROT	NEXTPROT_ID	NEXTPROT_ID
ORPHANET	ORPHANET_ID	ORPHANET_ID
PHARMGKB	PHARMGKB_ID	PHARMGKB_ID
POMBASE	POMBASE_ID	POMBASE_ID
PSEUDOCAP	PSEUDOCAP_ID	PSEUDOCAP_ID
RGD	RGD_ID	RGD_ID
SGD	SGD_ID	SGD_ID
TAIR	TAIR_ID	TAIR_ID
TUBERCULIST	TUBERCULIST_ID	TUBERCULIST_ID
WORMBASE	WORMBASE_ID	WORMBASE_ID
WORMBASE_TRANSCRIPT	WORMBASE_TRS_ID	WORMBASE_TRS_ID
WORMBASE_PROTEIN	WORMBASE_PRO_ID	WORMBASE_PRO_ID
XENBASE	XENBASE_ID	XENBASE_ID
ZFIN	ZFIN_ID	ZFIN_ID
EGGNOG	EGGNOG_ID	EGGNOG_ID
GENETREE	GENETREE_ID	GENETREE_ID
HOGENOM	HOGENOM_ID	HOGENOM_ID
KO	KO_ID	KO_ID
OMA	OMA_ID	OMA_ID
ORTHODB	ORTHODB_ID	ORTHODB_ID
PROTCLUSTDB	PROTCLUSTDB_ID	PROTCLUSTDB_ID
BIOCYC	BIOCYC_ID	BIOCYC_ID
REACTOME	REACTOME_ID	REACTOME_ID
UNIPATHWAY	UNIPATHWAY_ID	UNIPATHWAY_ID
CLEANEX	CLEANEX_ID	CLEANEX_ID
GERMONLINE	GERMONLINE_ID	GERMONLINE_ID
DRUGBANK	DRUGBANK_ID	DRUGBANK_ID
GENOMERNAI	GENOMERNAI_ID	GENOMERNAI_ID
NEXTBIO	NEXTBIO_ID	NEXTBIO_ID
